111111111111111
1P01C0C01000001
100000000000001
100000000000001
1000000000E0001
100000000000001
100000000000001
1000000V0000001
100000000000001
100000000000001
100100C00000001
111111111111111
